....................
..........#...#.....
..........#####.....
....................
...#................
...#................
...#................
.............####...
.............#..#...
.............#..#...
..##.........#..#...
....#...............
....#...............
....#...............
.#..................
.##.................
.........####.......
....................
....................
....................