....................
....................
....................
........#.....#.....
........#.....#.....
........#.....#.....
........#.....#.....
........#.....#.....
........#.....#.....
........#######.....
....................
....................
....................
....................
....................
....................
....................
....................
....................
#..................#