....................
....................
.....#######........
....................
....................
....................
........####........
....................
....................
....................
...........#####....
....................
...####.............
....................
.................##.
....................
....................
.....######.........
....................
....................